11111111
100001P1
100001E1
100C0001
10000011
100C0001
11111111
