11111111111111111111111
101000100010001000001E1
101010101010101010101C1
1C1000100010101000101P1
10100010001010101010101
10100010001000101010101
10001010101000001010101
101C0010001000101010101
10100010101010101010101
1C1C0010001010100010101
10101000101010001010101
10100010001000101010101
10101000000010001010101
10100010001000100010001
11111111111111111111111
