11111111
10000001
100000C1
100P0001
100000C1
100E0001
11111111
