1111111
1000001
1000001
100000z
1111111
