11111111111111111111111111111111
10000000000000000000000000000001
10000000000000000000000000000001
1000001111000000A000001111000001
10000011110000000000001111000001
10000000000000000000000000000001
100000000000000P0000000000000001
1000000000C00000000000000E000001
10000000100000000000000100000001
10000000010000000000001000000001
10000000001111111111110000000001
10000000000000000000000000000001
10000000000000000000000000000001
10000000000000000000000000000001
11111111111111111111111111111111
