11111111111111111111111
1P1C00100C10001C000C1E1
101010101010101010101C1
1C100010001C10100010101
10100010001010101C10101
10100010C01000101010101
10001010101000001010101
101C0010C0100C101010101
10100010101010101010101
1C1C0010001010100010101
10101000101010001010101
10100010C010C0101010101
10101000000010001010101
1010C010001000100C1C001
11111111111111111111111
