11111111111111111111111
101000100010001000001E1
1000100000100C001000001
10P00000000010100010001
10000010000010101010001
11111111111111111111111
