11111111111
1C-00C00C01
1P0C00C00E1
11111111111
