11111111111
10000000001
1P0C00C00E1
11111111111
