11111111111111111111111111111111
10P00000000100000000000000000001
10111111110111111111111111100001
10000000000000000000000000100001
10111011111111101111011110111001
10001010000000100001000000001001
10101010101110111001011111001001
10101010100000101001000000001001
10101010111110101101111111001001
10101000000000100000000000001001
10101111111010101111101111111001
10100000000010100000000000001001
10111111101110101111111011101001
10000000000000100000001000001001
11101110111110101111101111111001
10C00000000000000000000000000E01
11111111111111111111111111111111
