111111111111111
11A10A11C1010A1
111111E0A101001
1C0000000101001
111001111101111
100000000000011
110111110111001
1P00C1000001011
110001011101011
11C001C000C1001
111111111111111
