111111111111111
11010011C101001
111111100101001
1C0000000101001
111001111101111
100000000000011
110111110111001
1P00C1000001011
110001011101011
11C001C000C10E1
111111111111111
