111111111
100000001
1PC000E01
111111111
