11111111
1PCC1AE1
10000001
11111111
