11111111
1PCC10E1
100A0001
11111111
