11111111111111111111111111111111
10A000C000000000000000000P0000E1
100A0010000A000C0100A0100100A001
100A00100A000000010A001000000A01
100A001000000A000100A01000000A01
10A0001000A00000010A001000000A01
10A0000000A0000001000A100A000001
100A001000000A000100A0100A000001
10A00010000A0000010A001A00000001
10A00010000A000001000A100A000001
100A000100A00000010A00100A000001
100A001000A0000001000A100A000001
100A001000A000000A000A100A000001
1000A00100A000000100A0100A000001
1000A01000A000000100A0100A000001
1000A01000A000000100A01A00000001
11111111111111111111111111111111
