11111111111111111111111
1000A1000A0000000E00001
1000010000A00000P000001
1A000000000A00000000A01
100A00000000A0000A00001
10000A0A000000000000001
10001010101000001010101
101C0010C0100C101010101
10100010101010101010101
1C1C0010A0101010A010101
101010A0101010001010101
10100010C010C0101010101
10101000000010A01010101
101AC01000100A100C10A01
11111111111111111111111
