111111111111111111
10A000C0000000P001
10000010000A000C01
10E000100000A00001
100000100000000001
100000100000000001
1000001000000001A1
111111111111111111
