11111111111111111111111111111111
1AAAAAAAAAAAAAAAAAAAAAAAAAAACPE1
1AAAAAAAAAAAAAAAAAAAAAAAAAAAAAA1
1AAAAAAAAAAAAAAAAAAAAAAAAAAAAAA1
1AAAAAAAAAAAAAAAAAAAAAAAAAAAAAA1
1AAAAAAAAAAAAAAAAAAAAAAAAAAAAAA1
1AAAAAAAAAAAAAAAAAAAAAAAAAAAAAA1
1AAAAAAAAAAAAAAAAAAAAAAAAAAAAAA1
1AAAAAAAAAAAAAAAAAAAAAAAAAAAAAA1
1AAAAAAAAAAAAAAAAAAAAAAAAAAAAAA1
1AAAAAAAAAAAAAAAAAAAAAAAAAAAAAA1
1AAAAAAAAAAAAAAAAAAAAAAAAAAAAAA1
1AAAAAAAAAAAAAAAAAAAAAAAAAAAAAA1
1AAAAAAAAAAAAAAAAAAAAAAAAAAAAAA1
1AAAAAAAAAAAAAAAAAAAAAAAAAAAAAA1
1AAAAAAAAAAAAAAAAAAAAAAAAAAAAAA1
11111111111111111111111111111111
