1111111111111111
100010000C0000A1
10C0C0CPC0C0C0C1
1C0C0C0C0C0C0C01
100000000AA00001
1C0C0C0C0C0C0C01
1000A00000000001
1C0C00E00C0C0C01
1111111111111111
