1111111111111111
100000P000CAC0A1
100000C0000A0001
1000000000000001
1000000000000001
1000000000000001
1000000000000001
1A0000E001A1AAA1
1111111111111111
