1111111111111111
100010000C0000A1
1000000P00000001
1000000000000001
100000000AA00001
1000000000000001
1000A0A000000001
100000AE001A10A1
1111111111111111
