1111111111111111
1C0C0C0P0C0C0A01
10C0C0C0C0C0C0C1
1C0C0C0C0C0C0C01
10C0C0C0C0C0C0C1
1C0C0C0C0C0C0C01
10C0C0C0C0C0C0C1
1C0C00E00C0C0C01
1111111111111111
