1111111111111111
1A0C0C0P0C0C0C01
10C0C0C0C0C0C0C1
1C0C0C0C0C0C0C01
10C0C0C0C0C0C0C1
1C0C0C0C0C0C0C01
10C0C0C0C0C0C0C1
1C0C00E00C0CxC01
1111111111111111
