11111111111111111111111111111111
10A000C000000000000000000P0000E1
100A0010000A000C0100A0000100A001
100A00100000A0000100000A0100A001
100A001000000A000100A0000100A001
10A000100000A00001A000000100A001
10000010000A00000100000001000001
10000010000A00000100000001000001
1000001000A000000100000001000001
10000010000A00000100000001000001
10000010000000000100000001000001
10000010000000000100000001000001
10000010000000000100000001000001
10000010000000000100000001000001
10000010000000000100000001000001
10000010000000000100000001000001
11111111111111111111111111111111
